-1 -10 2 1 -3
%%%%%%%%%%%%%%%%%%%%
%  0   % G  %   0  %
% %%   %%1 %%  2%% %
% %  %       1%  % %
% %% % %%%%%% % %% %
%        P   2     %
%%%%%%%%%% %%%%%%%%%
